7	6	3	8	5	2	6	8	6	4	4	S	9	9	6	
1	8	1	4	7	#	8	7	8	8	3	3	5	8	6	
2	5	3	6	8	4	2	2	1	3	6	#	3	9	8	
5	1	#	9	5	6	1	6	8	3	1	8	9	#	1	
6	8	9	2	8	5	2	#	3	9	9	6	1	9	4	
2	1	9	5	7	4	1	6	6	3	3	#	4	3	5	
9	9	3	2	9	8	9	#	9	8	9	5	2	8	#	
1	7	4	1	6	9	3	#	#	7	4	4	5	3	8	
2	6	5	#	3	1	4	8	7	7	6	5	1	7	1	
1	#	6	2	5	#	#	#	9	8	8	6	7	6	3	
8	6	#	2	5	4	8	3	8	5	7	2	6	1	3	
3	4	4	4	2	2	5	2	5	#	8	6	1	5	7	
3	3	2	2	#	2	8	7	1	#	3	6	9	4	9	
6	2	7	2	1	9	5	3	4	4	6	#	8	1	6	
5	6	2	6	4	9	2	#	8	1	7	3	#	9	4	
9	1	3	7	6	2	6	2	4	3	5	7	1	8	3	
3	3	4	6	8	9	8	7	6	6	3	3	9	6	6	
7	8	#	8	4	4	7	1	4	5	5	#	9	2	2	
3	1	2	4	3	9	2	5	2	8	G	3	9	7	7	
2	3	4	3	5	3	8	9	8	3	6	#	7	6	5	
