7	8	5	4	7	8	6	6	9	4	2	9	#	9	5	
6	5	6	4	#	2	G	1	4	9	1	9	2	5	8	
6	#	8	1	2	3	8	#	5	1	2	9	2	1	2	
4	#	1	3	9	6	4	7	5	8	3	7	6	7	7	
1	5	2	5	7	7	5	2	9	1	4	4	7	7	6	
5	5	6	9	6	5	3	4	6	8	9	6	9	4	#	
9	5	5	2	6	6	1	7	2	9	#	#	8	7	3	
3	5	7	6	7	2	4	4	3	8	6	7	4	9	4	
4	5	1	5	#	5	#	1	6	5	2	6	4	7	3	
8	7	9	4	9	3	8	9	#	9	9	3	3	2	9	
9	1	7	9	6	#	1	#	9	2	2	3	2	4	5	
6	9	8	8	5	1	1	1	#	2	#	9	9	1	6	
1	6	4	5	6	9	2	7	4	2	7	2	7	2	8	
2	6	2	3	6	9	#	6	1	1	1	5	7	2	6	
1	4	#	9	1	3	5	8	5	6	1	#	4	#	7	
6	9	8	#	1	1	3	5	7	3	4	7	7	6	4	
4	9	S	2	9	#	8	7	5	7	2	9	4	3	6	
8	3	8	6	6	2	9	2	#	#	4	1	9	3	3	
4	4	7	1	7	1	9	9	9	1	7	3	5	6	2	
5	7	#	5	9	6	4	4	5	6	1	4	8	3	6	
