7	7	3	8	3	8	6	4	3	7	2	3	1	6	3	
8	7	#	1	1	6	6	4	8	4	8	3	1	#	#	
2	6	1	5	9	#	1	4	6	8	1	8	9	2	5	
4	4	9	8	6	2	8	3	7	1	5	1	9	6	2	
3	2	4	6	4	3	1	5	8	3	9	4	#	3	6	
9	5	8	1	5	2	6	4	6	4	5	8	9	6	4	
2	4	6	7	9	1	7	#	7	6	3	2	7	5	3	
1	5	7	6	6	6	2	6	5	S	8	5	5	7	8	
7	3	8	1	9	5	7	1	#	2	8	3	1	3	4	
6	8	8	9	5	1	3	2	8	9	8	6	9	1	9	
3	3	#	2	1	5	1	1	8	4	5	3	9	#	4	
9	7	1	5	5	G	2	1	7	7	1	5	#	1	1	
6	5	6	5	7	6	7	8	8	8	6	2	1	9	4	
5	8	8	1	9	7	9	7	#	6	9	9	4	2	5	
5	3	1	4	3	5	4	3	5	4	2	8	2	9	3	
8	5	4	7	3	5	#	3	2	2	8	8	6	#	2	
5	4	9	6	1	7	6	5	4	3	3	2	3	6	6	
1	5	1	2	2	8	7	1	4	6	2	7	5	5	9	
3	9	9	1	5	3	9	1	9	2	7	8	9	8	1	
3	8	8	2	1	8	6	2	8	1	9	8	7	8	1	
